unit;TERYT;constituency;candidates;winners;losers;biggest winner votes;biggest loser votes;losers with more votes than winner
bolesławiecki;20100;1;112;10;102;308;413;5
bolesławiecki;20100;2;58;5;53;275;232;0
bolesławiecki;20100;3;77;6;71;224;375;6
dzierżoniowski;20200;1;61;7;54;181;416;7
dzierżoniowski;20200;2;94;8;86;276;292;1
dzierżoniowski;20200;3;44;4;40;432;616;1
dzierżoniowski;20200;4;27;4;23;420;478;1
głogowski;20300;1;23;3;20;436;419;0
głogowski;20300;2;36;5;31;172;356;5
głogowski;20300;3;31;4;27;447;298;0
głogowski;20300;4;29;4;25;253;348;1
głogowski;20300;5;35;5;30;498;591;1
górowski;20400;1;70;9;61;187;237;3
górowski;20400;2;30;3;27;201;326;1
górowski;20400;3;29;3;26;189;328;3
jaworski;20500;1;90;8;82;196;265;2
jaworski;20500;2;42;4;38;254;229;0
jaworski;20500;3;51;5;46;389;307;0
jeleniogórski;20600;1;40;4;36;329;316;0
jeleniogórski;20600;2;34;3;31;267;316;1
jeleniogórski;20600;3;41;4;37;360;258;0
jeleniogórski;20600;4;43;4;39;201;343;3
jeleniogórski;20600;5;38;4;34;286;235;0
kamiennogórski;20700;1;98;8;90;177;304;3
kamiennogórski;20700;2;64;5;59;214;285;1
kamiennogórski;20700;3;54;4;50;279;243;0
kłodzki;20800;1;50;5;45;465;370;0
kłodzki;20800;2;50;5;45;377;605;3
kłodzki;20800;3;39;4;35;387;462;2
kłodzki;20800;4;39;4;35;306;445;6
kłodzki;20800;5;35;4;31;339;534;2
kłodzki;20800;6;39;4;35;572;557;0
kłodzki;20800;7;29;3;26;400;422;1
legnicki;20900;1;33;5;28;168;284;2
legnicki;20900;2;22;3;19;305;311;1
legnicki;20900;3;21;3;18;258;351;2
legnicki;20900;4;22;3;19;356;338;0
legnicki;20900;5;21;3;18;335;314;0
lubański;21000;1;40;5;35;205;356;5
lubański;21000;2;37;5;32;264;395;4
lubański;21000;3;60;7;53;334;317;0
lubiński;21100;1;42;4;38;210;358;3
lubiński;21100;2;44;4;40;459;403;0
lubiński;21100;3;45;4;41;365;509;2
lubiński;21100;4;42;4;38;480;545;1
lubiński;21100;5;78;7;71;384;490;2
lwówecki;21200;1;28;4;24;376;211;0
lwówecki;21200;2;63;6;57;138;234;5
lwówecki;21200;3;19;3;16;252;264;2
lwówecki;21200;4;41;4;37;194;214;1
milicki;21300;1;100;10;90;197;222;3
milicki;21300;2;53;5;48;186;235;3
oleśnicki;21400;1;54;8;46;383;426;1
oleśnicki;21400;2;31;5;26;484;605;1
oleśnicki;21400;3;25;4;21;465;423;0
oleśnicki;21400;4;39;6;33;434;421;0
oławski;21500;1;84;8;76;175;343;4
oławski;21500;2;61;6;55;209;419;2
oławski;21500;3;54;5;49;303;410;1
polkowicki;21600;1;48;8;40;336;419;3
polkowicki;21600;2;32;4;28;254;302;3
polkowicki;21600;3;23;3;20;210;486;1
polkowicki;21600;4;21;4;17;560;562;1
strzeliński;21700;1;62;8;54;274;285;1
strzeliński;21700;2;25;4;21;252;272;2
strzeliński;21700;3;31;5;26;252;323;1
średzki;21800;1;84;7;77;210;297;3
średzki;21800;2;75;6;69;228;308;3
średzki;21800;3;41;4;37;178;297;3
świdnicki;21900;1;68;6;62;412;456;1
świdnicki;21900;2;55;5;50;400;357;0
świdnicki;21900;3;54;5;49;256;706;6
świdnicki;21900;4;50;5;45;321;836;5
świdnicki;21900;5;29;3;26;415;362;0
świdnicki;21900;6;53;5;48;439;584;2
trzebnicki;22000;1;38;5;33;379;409;1
trzebnicki;22000;2;31;4;27;444;280;0
trzebnicki;22000;3;41;4;37;270;380;2
trzebnicki;22000;4;50;6;44;324;491;2
wałbrzyski;22100;1;37;4;33;505;480;0
wałbrzyski;22100;2;36;4;32;420;1141;1
wałbrzyski;22100;3;35;4;31;370;601;2
wałbrzyski;22100;4;36;4;32;503;632;1
wałbrzyski;22100;5;32;4;28;506;465;0
wałbrzyski;22100;6;42;5;37;674;672;0
wałbrzyski;22100;7;38;4;34;568;558;0
wołowski;22200;1;68;8;60;165;278;4
wołowski;22200;2;36;6;30;188;280;7
wołowski;22200;3;15;3;12;364;479;1
wrocławski;22300;1;59;7;52;490;584;2
wrocławski;22300;2;25;3;22;317;532;3
wrocławski;22300;3;44;5;39;368;320;0
wrocławski;22300;4;27;3;24;639;583;0
wrocławski;22300;5;46;5;41;327;401;1
ząbkowicki;22400;1;43;3;40;331;208;0
ząbkowicki;22400;2;79;6;73;282;237;0
ząbkowicki;22400;3;56;4;52;233;225;0
ząbkowicki;22400;4;92;6;86;281;325;1
zgorzelecki;22500;1;78;7;71;450;444;0
zgorzelecki;22500;2;67;6;61;478;341;0
zgorzelecki;22500;3;47;4;43;343;351;1
zgorzelecki;22500;4;46;4;42;417;410;0
złotoryjski;22600;1;77;6;71;145;134;0
złotoryjski;22600;2;35;3;32;131;216;2
złotoryjski;22600;3;50;4;46;207;190;0
złotoryjski;22600;4;48;4;44;236;207;0
Jelenia Góra;26101;1;82;6;76;293;377;1
Jelenia Góra;26101;2;74;6;68;279;209;0
Jelenia Góra;26101;3;58;5;53;217;312;3
Jelenia Góra;26101;4;75;6;69;232;361;4
Legnica;26201;1;54;5;49;225;312;4
Legnica;26201;2;58;5;53;283;379;1
Legnica;26201;3;55;5;50;275;239;0
Legnica;26201;4;50;5;45;387;375;0
Legnica;26201;5;55;5;50;377;560;2
Wrocław;26401;1;92;6;86;1126;1021;0
Wrocław;26401;2;75;5;70;1671;1619;0
Wrocław;26401;3;90;6;84;1350;1218;0
Wrocław;26401;4;78;5;73;1020;1259;2
Wrocław;26401;5;79;5;74;1472;1475;1
Wrocław;26401;6;69;5;64;1488;1455;0
Wrocław;26401;7;78;5;73;1680;1466;0
aleksandrowski;40100;1;41;4;37;201;252;3
aleksandrowski;40100;2;27;3;24;238;591;1
aleksandrowski;40100;3;22;3;19;308;302;0
aleksandrowski;40100;4;25;3;22;348;243;0
aleksandrowski;40100;5;28;4;24;247;268;2
brodnicki;40200;1;60;7;53;249;429;3
brodnicki;40200;2;36;4;32;295;319;1
brodnicki;40200;3;45;5;40;358;375;1
brodnicki;40200;4;30;3;27;194;331;4
bydgoski;40300;1;51;5;46;268;319;2
bydgoski;40300;2;36;4;32;247;255;1
bydgoski;40300;3;57;6;51;256;310;4
bydgoski;40300;4;37;4;33;377;418;1
bydgoski;40300;5;32;4;28;387;457;2
chełmiński;40400;1;68;7;61;167;211;2
chełmiński;40400;2;32;3;29;194;274;1
chełmiński;40400;3;43;4;39;181;165;0
chełmiński;40400;4;31;3;28;425;315;0
golubsko-dobrzyński;40500;1;57;5;52;159;185;1
golubsko-dobrzyński;40500;2;35;3;32;351;346;0
golubsko-dobrzyński;40500;3;64;6;58;237;301;2
golubsko-dobrzyński;40500;4;28;3;25;163;310;2
grudziądzki;40600;1;54;5;49;96;167;1
grudziądzki;40600;2;40;3;37;283;215;0
grudziądzki;40600;3;44;4;40;194;246;1
grudziądzki;40600;4;55;5;50;164;169;1
inowrocławski;40700;1;40;5;35;242;528;2
inowrocławski;40700;2;38;4;34;431;585;1
inowrocławski;40700;3;57;5;52;347;502;2
inowrocławski;40700;4;30;3;27;753;634;0
inowrocławski;40700;5;36;4;32;333;889;3
inowrocławski;40700;6;43;4;39;309;429;3
inowrocławski;40700;7;42;4;38;345;323;0
lipnowski;40800;1;32;4;28;326;373;1
lipnowski;40800;2;37;4;33;353;327;0
lipnowski;40800;3;38;4;34;255;266;1
lipnowski;40800;4;39;4;35;249;241;0
lipnowski;40800;5;28;3;25;114;257;5
mogileński;40900;1;73;9;64;179;383;3
mogileński;40900;2;25;4;21;270;254;0
mogileński;40900;3;35;4;31;234;291;3
nakielski;41000;1;75;8;67;281;359;3
nakielski;41000;2;24;3;21;298;364;3
nakielski;41000;3;30;4;26;248;480;1
nakielski;41000;4;66;6;60;253;307;1
radziejowski;41100;1;51;4;47;206;217;1
radziejowski;41100;2;35;3;32;221;284;3
radziejowski;41100;3;80;6;74;221;297;1
radziejowski;41100;4;55;4;51;137;214;6
rypiński;41200;1;106;6;100;111;244;7
rypiński;41200;2;47;3;44;170;213;2
rypiński;41200;3;62;4;58;181;181;0
rypiński;41200;4;64;4;60;216;220;1
sępoleński;41300;1;58;7;51;109;166;4
sępoleński;41300;2;52;5;47;84;190;8
sępoleński;41300;3;40;5;35;137;157;1
świecki;41400;1;55;7;48;185;526;8
świecki;41400;2;48;5;43;252;568;4
świecki;41400;3;44;5;39;257;283;2
świecki;41400;4;39;4;35;439;374;0
toruński;41500;1;30;3;27;350;317;0
toruński;41500;2;37;4;33;513;390;0
toruński;41500;3;47;5;42;433;620;1
toruński;41500;4;47;5;42;353;387;1
toruński;41500;5;34;4;30;552;492;0
tucholski;41600;1;90;7;83;141;304;6
tucholski;41600;2;46;4;42;144;144;0
tucholski;41600;3;68;6;62;209;252;2
wąbrzeski;41700;1;72;6;66;117;158;4
wąbrzeski;41700;2;31;3;28;226;237;1
wąbrzeski;41700;3;67;6;61;170;152;0
włocławski;41800;1;44;4;40;374;298;0
włocławski;41800;2;51;4;47;329;410;1
włocławski;41800;3;40;3;37;261;337;2
włocławski;41800;4;36;3;33;313;262;0
włocławski;41800;5;36;3;33;450;650;1
włocławski;41800;6;48;4;44;356;341;0
żniński;41900;1;89;7;82;294;299;1
żniński;41900;2;67;6;61;290;349;2
żniński;41900;3;68;6;62;336;312;0
Bydgoszcz;46101;1;65;5;60;1175;1078;0
Bydgoszcz;46101;2;66;5;61;1201;905;0
Bydgoszcz;46101;3;94;6;88;675;1276;2
Bydgoszcz;46101;4;69;5;64;1143;1264;1
Bydgoszcz;46101;5;64;5;59;486;729;2
Bydgoszcz;46101;6;76;5;71;1271;876;0
Grudziądz;46201;1;82;5;77;220;239;1
Grudziądz;46201;2;79;5;74;231;313;1
Grudziądz;46201;3;77;5;72;263;468;3
Grudziądz;46201;4;129;8;121;336;394;1
Toruń;46301;1;57;6;51;472;483;1
Toruń;46301;2;54;5;49;802;528;0
Toruń;46301;3;56;6;50;782;591;0
Toruń;46301;4;73;8;65;364;522;2
Włocławek;46401;1;70;5;65;468;250;0
Włocławek;46401;2;74;5;69;376;403;1
Włocławek;46401;3;74;5;69;235;306;1
Włocławek;46401;4;68;5;63;518;468;0
Włocławek;46401;5;69;5;64;242;373;2
bialski;60100;1;22;3;19;399;555;1
bialski;60100;2;31;4;27;491;606;1
bialski;60100;3;30;4;26;448;533;1
bialski;60100;4;23;3;20;445;490;1
bialski;60100;5;23;3;20;657;362;0
bialski;60100;6;24;3;21;707;394;0
bialski;60100;7;23;3;20;582;504;0
biłgorajski;60200;1;69;6;63;303;628;4
biłgorajski;60200;2;34;3;31;533;513;0
biłgorajski;60200;3;30;3;27;382;355;0
biłgorajski;60200;4;44;4;40;390;375;0
biłgorajski;60200;5;48;4;44;399;433;2
biłgorajski;60200;6;34;3;31;380;809;3
chełmski;60300;1;56;6;50;223;314;6
chełmski;60300;2;20;3;17;293;348;2
chełmski;60300;3;28;3;25;385;385;0
chełmski;60300;4;45;5;40;335;332;0
chełmski;60300;5;35;4;31;311;489;3
hrubieszowski;60400;1;58;5;53;203;246;2
hrubieszowski;60400;2;30;3;27;331;268;0
hrubieszowski;60400;3;43;4;39;163;197;4
hrubieszowski;60400;4;44;4;40;171;483;6
hrubieszowski;60400;5;30;3;27;331;289;0
janowski;60500;1;26;3;23;466;355;0
janowski;60500;2;37;4;33;278;333;1
janowski;60500;3;72;6;66;270;329;1
janowski;60500;4;44;4;40;390;408;1
krasnostawski;60600;1;60;5;55;215;221;1
krasnostawski;60600;2;60;5;55;193;326;3
krasnostawski;60600;3;59;5;54;407;402;0
krasnostawski;60600;4;48;4;44;243;387;3
kraśnicki;60700;1;62;8;54;385;410;1
kraśnicki;60700;2;45;5;40;479;472;0
kraśnicki;60700;3;46;5;41;515;500;0
kraśnicki;60700;4;44;5;39;582;472;0
lubartowski;60800;1;52;5;47;270;457;6
lubartowski;60800;2;56;6;50;346;424;1
lubartowski;60800;3;48;5;43;289;603;3
lubartowski;60800;4;51;5;46;324;369;3
lubelski;60900;1;45;5;40;557;660;1
lubelski;60900;2;41;4;37;637;433;0
lubelski;60900;3;36;4;32;423;633;2
lubelski;60900;4;49;5;44;540;610;4
lubelski;60900;5;39;4;35;457;436;0
lubelski;60900;6;53;5;48;410;558;2
łęczyński;61000;1;43;4;39;368;300;0
łęczyński;61000;2;36;3;33;266;250;0
łęczyński;61000;3;93;7;86;194;289;5
łęczyński;61000;4;34;3;31;328;308;0
łukowski;61100;1;84;6;78;308;403;4
łukowski;61100;2;70;5;65;486;481;0
łukowski;61100;3;66;6;60;528;493;0
łukowski;61100;4;76;6;70;346;534;3
opolski;61200;1;57;5;52;282;260;0
opolski;61200;2;49;5;44;302;291;0
opolski;61200;3;45;4;41;325;304;0
opolski;61200;4;48;5;43;230;388;3
parczewski;61300;1;71;6;65;215;262;3
parczewski;61300;2;58;5;53;128;207;10
parczewski;61300;3;44;4;40;227;225;0
puławski;61400;1;98;10;88;351;453;5
puławski;61400;2;31;3;28;557;547;0
puławski;61400;3;30;3;27;455;493;1
puławski;61400;4;31;3;28;406;383;0
puławski;61400;5;37;4;33;405;768;1
radzyński;61500;1;60;5;55;273;313;4
radzyński;61500;2;105;8;97;231;386;3
radzyński;61500;3;82;6;76;305;410;2
rycki;61600;1;38;5;33;401;389;0
rycki;61600;2;66;7;59;230;288;3
rycki;61600;3;61;7;54;194;478;9
świdnicki;61700;1;48;6;42;340;305;0
świdnicki;61700;2;43;5;38;304;281;0
świdnicki;61700;3;61;8;53;361;385;2
tomaszowski;61800;1;64;5;59;244;398;4
tomaszowski;61800;2;59;5;54;320;312;0
tomaszowski;61800;3;38;3;35;349;553;2
tomaszowski;61800;4;37;3;34;621;612;0
tomaszowski;61800;5;64;5;59;361;455;2
włodawski;61900;1;58;6;52;240;276;1
włodawski;61900;2;35;4;31;168;306;2
włodawski;61900;3;37;4;33;242;247;1
włodawski;61900;4;27;3;24;290;214;0
zamojski;62000;1;47;4;43;431;394;0
zamojski;62000;2;47;4;43;359;397;1
zamojski;62000;3;45;4;41;378;398;1
zamojski;62000;4;48;4;44;416;444;1
zamojski;62000;5;35;3;32;424;500;1
zamojski;62000;6;46;4;42;366;389;2
Biała Podlaska;66101;1;71;6;65;114;246;6
Biała Podlaska;66101;2;71;5;66;140;296;4
Biała Podlaska;66101;3;64;5;59;182;207;1
Biała Podlaska;66101;4;82;7;75;191;199;1
Chełm;66201;1;69;6;63;273;161;0
Chełm;66201;2;69;6;63;249;304;2
Chełm;66201;3;60;5;55;176;270;3
Chełm;66201;4;69;6;63;300;332;1
Lublin;66301;1;83;5;78;707;584;0
Lublin;66301;2;66;5;61;1022;1297;1
Lublin;66301;3;77;5;72;948;1121;2
Lublin;66301;4;99;6;93;749;1531;3
Lublin;66301;5;85;5;80;998;1261;1
Lublin;66301;6;80;5;75;1493;1368;0
Zamość;66401;1;56;5;51;313;244;0
Zamość;66401;2;64;6;58;146;155;2
Zamość;66401;3;55;5;50;236;233;0
Zamość;66401;4;78;7;71;148;235;3
gorzowski;80100;1;47;5;42;149;303;7
gorzowski;80100;2;29;4;25;276;226;0
gorzowski;80100;3;38;4;34;208;347;1
gorzowski;80100;4;53;6;47;276;262;0
krośnieński;80200;1;44;5;39;209;274;2
krośnieński;80200;2;72;6;66;246;340;3
krośnieński;80200;3;34;3;31;176;295;5
krośnieński;80200;4;32;3;29;248;260;1
międzyrzecki;80300;1;28;3;25;228;255;1
międzyrzecki;80300;2;39;7;32;539;518;0
międzyrzecki;80300;3;23;3;20;398;411;1
międzyrzecki;80300;4;32;4;28;212;427;3
nowosolski;80400;1;109;10;99;225;339;4
nowosolski;80400;2;42;4;38;224;386;3
nowosolski;80400;3;33;3;30;249;376;5
nowosolski;80400;4;42;4;38;253;292;1
słubicki;80500;1;51;6;45;273;308;2
słubicki;80500;2;36;4;32;219;391;2
słubicki;80500;3;68;7;61;199;293;3
strzelecko-drezdenecki;80600;1;45;6;39;98;306;9
strzelecko-drezdenecki;80600;2;54;6;48;157;231;2
strzelecko-drezdenecki;80600;3;40;5;35;240;230;0
sulęciński;80700;1;93;8;85;152;210;3
sulęciński;80700;2;40;4;36;245;254;1
sulęciński;80700;3;34;3;31;155;155;0
świebodziński;80800;1;116;9;107;214;217;1
świebodziński;80800;2;36;4;32;319;282;0
świebodziński;80800;3;40;4;36;187;291;3
zielonogórski;80900;1;54;6;48;251;353;3
zielonogórski;80900;2;39;4;35;500;662;2
zielonogórski;80900;3;41;5;36;339;345;1
zielonogórski;80900;4;49;6;43;345;333;0
żagański;81000;1;98;7;91;105;242;10
żagański;81000;2;45;3;42;224;270;4
żagański;81000;3;42;3;39;148;197;3
żagański;81000;4;105;8;97;265;400;3
żarski;81100;1;59;8;51;405;388;0
żarski;81100;2;34;4;30;209;359;2
żarski;81100;3;34;4;30;308;291;0
żarski;81100;4;36;5;31;246;453;5
wschowski;81200;1;116;8;108;142;291;6
wschowski;81200;2;86;7;79;114;190;9
Gorzów Wielkopolski;86101;1;59;5;54;380;367;0
Gorzów Wielkopolski;86101;2;55;5;50;186;455;2
Gorzów Wielkopolski;86101;3;54;5;49;426;506;1
Gorzów Wielkopolski;86101;4;60;5;55;214;264;1
Gorzów Wielkopolski;86101;5;53;5;48;357;353;0
Zielona Góra;86201;1;51;5;46;374;544;2
Zielona Góra;86201;2;50;5;45;258;208;0
Zielona Góra;86201;3;50;5;45;307;722;3
Zielona Góra;86201;4;51;5;46;554;362;0
Zielona Góra;86201;5;50;5;45;321;319;0
bełchatowski;100100;1;60;6;54;271;458;2
bełchatowski;100100;2;69;7;62;214;496;5
bełchatowski;100100;3;30;3;27;554;527;0
bełchatowski;100100;4;30;3;27;515;767;1
bełchatowski;100100;5;36;4;32;412;807;5
kutnowski;100200;1;132;10;122;195;474;5
kutnowski;100200;2;54;4;50;316;361;1
kutnowski;100200;3;40;3;37;230;503;2
kutnowski;100200;4;47;3;44;256;358;2
kutnowski;100200;5;43;3;40;267;306;2
łaski;100300;1;109;10;99;224;258;1
łaski;100300;2;73;7;66;307;437;2
łęczycki;100400;1;68;5;63;174;231;3
łęczycki;100400;2;40;3;37;304;224;0
łęczycki;100400;3;68;5;63;241;195;0
łęczycki;100400;4;53;4;49;226;254;2
łowicki;100500;1;97;8;89;229;388;6
łowicki;100500;2;40;4;36;256;309;1
łowicki;100500;3;24;3;21;396;392;0
łowicki;100500;4;34;3;31;386;336;0
łowicki;100500;5;26;3;23;386;508;1
łódzki wschodni;100600;1;21;3;18;281;374;2
łódzki wschodni;100600;2;27;4;23;359;421;1
łódzki wschodni;100600;3;37;5;32;401;482;1
łódzki wschodni;100600;4;70;7;63;226;373;4
opoczyński;100700;1;100;9;91;346;479;2
opoczyński;100700;2;48;4;44;328;463;4
opoczyński;100700;3;91;8;83;375;656;4
pabianicki;100800;1;31;4;27;250;323;1
pabianicki;100800;2;29;4;25;383;341;0
pabianicki;100800;3;23;3;20;475;461;0
pabianicki;100800;4;23;3;20;311;307;0
pabianicki;100800;5;24;3;21;940;517;0
pabianicki;100800;6;43;6;37;514;456;0
pajęczański;100900;1;35;4;31;278;516;2
pajęczański;100900;2;25;3;22;281;537;4
pajęczański;100900;3;24;3;21;209;393;4
pajęczański;100900;4;32;4;28;367;312;0
pajęczański;100900;5;25;3;22;394;443;1
piotrkowski;101000;1;35;3;32;385;436;3
piotrkowski;101000;2;67;6;61;319;363;4
piotrkowski;101000;3;59;5;54;395;449;1
piotrkowski;101000;4;40;4;36;412;378;0
piotrkowski;101000;5;34;3;31;465;338;0
poddębicki;101100;1;48;6;42;248;267;1
poddębicki;101100;2;22;3;19;284;271;0
poddębicki;101100;3;24;3;21;168;267;1
poddębicki;101100;4;36;5;31;382;334;0
radomszczański;101200;1;118;9;109;322;598;3
radomszczański;101200;2;31;3;28;467;617;3
radomszczański;101200;3;29;3;26;662;612;0
radomszczański;101200;4;38;4;34;318;469;8
radomszczański;101200;5;39;4;35;452;530;2
rawski;101300;1;56;6;50;180;234;6
rawski;101300;2;33;4;29;204;339;2
rawski;101300;3;24;3;21;157;172;2
rawski;101300;4;30;4;26;163;277;3
sieradzki;101400;1;72;9;63;259;428;5
sieradzki;101400;2;24;3;21;451;443;0
sieradzki;101400;3;18;3;15;677;411;0
sieradzki;101400;4;20;3;17;758;664;0
sieradzki;101400;5;31;4;27;825;453;0
sieradzki;101400;6;21;3;18;635;749;1
skierniewicki;101500;1;84;8;76;188;319;4
skierniewicki;101500;2;34;3;31;94;144;4
skierniewicki;101500;3;36;4;32;313;383;1
tomaszowski;101600;1;24;3;21;291;278;0
tomaszowski;101600;2;28;3;25;319;318;0
tomaszowski;101600;3;36;4;32;429;359;0
tomaszowski;101600;4;40;4;36;260;375;1
tomaszowski;101600;5;23;3;20;773;795;2
tomaszowski;101600;6;42;4;38;596;588;0
tomaszowski;101600;7;30;4;26;558;622;2
wieluński;101700;1;106;8;98;311;362;2
wieluński;101700;2;75;6;69;345;585;2
wieluński;101700;3;67;5;62;355;453;1
wieruszowski;101800;1;50;6;44;167;279;3
wieruszowski;101800;2;44;6;38;255;292;2
wieruszowski;101800;3;34;5;29;299;247;0
zduńskowolski;101900;1;52;4;48;229;260;1
zduńskowolski;101900;2;50;4;46;149;399;4
zduńskowolski;101900;3;50;4;46;312;337;1
zduńskowolski;101900;4;40;3;37;265;194;0
zduńskowolski;101900;5;50;4;46;279;277;0
zgierski;102000;1;103;10;93;298;452;6
zgierski;102000;2;38;4;34;483;508;1
zgierski;102000;3;61;6;55;451;512;1
zgierski;102000;4;41;5;36;779;726;0
zgierski;102000;5;47;4;43;612;557;0
brzeziński;102100;1;42;6;36;221;283;2
brzeziński;102100;2;35;5;30;211;288;2
brzeziński;102100;3;28;4;24;202;234;2
Łódź;106101;1;97;5;92;1929;1012;0
Łódź;106101;2;104;6;98;1209;1871;1
Łódź;106101;3;102;6;96;865;2140;2
Łódź;106101;4;101;5;96;857;611;0
Łódź;106101;5;92;5;87;1237;973;0
Łódź;106101;6;109;6;103;1447;1320;0
Łódź;106101;7;104;5;99;1358;1421;1
Łódź;106101;8;86;5;81;553;1149;5
Piotrków Trybunalski;106201;1;49;5;44;293;355;1
Piotrków Trybunalski;106201;2;50;5;45;335;333;0
Piotrków Trybunalski;106201;3;70;7;63;251;339;2
Piotrków Trybunalski;106201;4;58;6;52;224;227;1
Skierniewice;106301;1;84;6;78;140;248;2
Skierniewice;106301;2;67;5;62;186;171;0
Skierniewice;106301;3;70;5;65;184;247;1
Skierniewice;106301;4;68;5;63;158;184;1
bocheński;120100;1;97;7;90;312;302;0
bocheński;120100;2;47;4;43;362;374;1
bocheński;120100;3;31;3;28;437;418;0
bocheński;120100;4;43;4;39;325;413;1
bocheński;120100;5;50;5;45;301;607;3
brzeski;120200;1;82;8;74;223;406;5
brzeski;120200;2;33;3;30;341;259;0
brzeski;120200;3;49;5;44;280;285;1
brzeski;120200;4;43;5;38;542;499;0
chrzanowski;120300;1;34;4;30;540;648;1
chrzanowski;120300;2;92;10;82;216;375;10
chrzanowski;120300;3;39;4;35;633;567;0
chrzanowski;120300;4;63;7;56;276;487;5
dąbrowski;120400;1;48;6;42;347;351;1
dąbrowski;120400;2;48;5;43;430;355;0
dąbrowski;120400;3;63;6;57;267;402;3
gorlicki;120500;1;57;6;51;278;425;6
gorlicki;120500;2;27;3;24;421;490;1
gorlicki;120500;3;34;4;30;104;282;9
gorlicki;120500;4;42;5;37;374;382;1
gorlicki;120500;5;41;5;36;368;444;4
krakowski;120600;1;27;3;24;968;658;0
krakowski;120600;2;21;3;18;1143;841;0
krakowski;120600;3;27;3;24;549;786;2
krakowski;120600;4;28;4;24;898;1150;3
krakowski;120600;5;36;4;32;523;935;3
krakowski;120600;6;29;4;25;947;1053;1
krakowski;120600;7;37;5;32;840;816;0
krakowski;120600;8;24;3;21;1155;1089;0
limanowski;120700;1;24;3;21;678;624;0
limanowski;120700;2;43;6;37;593;836;1
limanowski;120700;3;24;3;21;388;398;1
limanowski;120700;4;24;3;21;475;418;0
limanowski;120700;5;37;5;32;193;719;4
limanowski;120700;6;41;5;36;418;447;1
miechowski ;120800;1;62;5;57;258;228;0
miechowski ;120800;2;51;5;46;338;419;1
miechowski ;120800;3;116;7;109;252;297;1
myślenicki;120900;1;84;8;76;336;461;7
myślenicki;120900;2;38;3;35;507;542;1
myślenicki;120900;3;42;4;38;275;613;4
myślenicki;120900;4;36;4;32;520;479;0
myślenicki;120900;5;39;4;35;455;535;1
nowosądecki;121000;1;32;4;28;863;723;0
nowosądecki;121000;2;30;4;26;453;757;3
nowosądecki;121000;3;39;5;34;933;835;0
nowosądecki;121000;4;32;4;28;773;779;1
nowosądecki;121000;5;27;3;24;741;591;0
nowosądecki;121000;6;47;6;41;894;1039;1
nowosądecki;121000;7;27;3;24;504;705;2
nowotarski;121100;1;37;5;32;711;584;0
nowotarski;121100;2;36;6;30;456;564;4
nowotarski;121100;3;31;5;26;504;497;0
nowotarski;121100;4;23;3;20;347;389;3
nowotarski;121100;5;26;4;22;754;694;0
nowotarski;121100;6;23;3;20;270;555;3
nowotarski;121100;7;23;3;20;806;530;0
olkuski;121200;1;101;10;91;371;446;2
olkuski;121200;2;24;3;21;876;753;0
olkuski;121200;3;64;6;58;357;450;3
olkuski;121200;4;34;4;30;244;421;7
oświęcimski;121300;1;66;7;59;681;633;0
oświęcimski;121300;2;45;5;40;552;649;3
oświęcimski;121300;3;40;4;36;418;570;2
oświęcimski;121300;4;53;6;47;440;410;0
oświęcimski;121300;5;43;5;38;651;573;0
proszowicki;121400;1;27;4;23;226;153;0
proszowicki;121400;2;30;4;26;167;354;5
proszowicki;121400;3;17;3;14;307;277;0
proszowicki;121400;4;42;6;36;300;266;0
Suski;121500;1;23;3;20;360;389;1
Suski;121500;2;31;4;27;381;497;1
Suski;121500;3;32;4;28;329;333;1
Suski;121500;4;30;4;26;696;460;0
Suski;121500;5;47;6;41;290;374;2
tarnowski;121600;1;39;3;36;201;588;4
tarnowski;121600;2;39;3;36;451;616;2
tarnowski;121600;3;68;5;63;408;730;6
tarnowski;121600;4;50;4;46;414;570;2
tarnowski;121600;5;51;4;47;505;811;2
tarnowski;121600;6;76;6;70;567;537;0
tarnowski;121600;7;51;4;47;544;629;1
tatrzański;121700;1;98;8;90;219;356;4
tatrzański;121700;2;27;4;23;346;330;0
tatrzański;121700;3;49;7;42;227;322;5
wadowicki;121800;1;62;8;54;417;581;5
wadowicki;121800;2;58;6;52;443;545;2
wadowicki;121800;3;29;3;26;342;463;2
wadowicki;121800;4;29;3;26;425;395;0
wadowicki;121800;5;61;7;54;417;416;0
wielicki;121900;1;54;7;47;514;605;1
wielicki;121900;2;38;5;33;429;549;2
wielicki;121900;3;32;4;28;305;318;1
wielicki;121900;4;56;7;49;327;471;1
Kraków;126101;1;106;7;99;1301;1269;0
Kraków;126101;2;101;7;94;1532;1900;1
Kraków;126101;3;79;6;73;2191;1730;0
Kraków;126101;4;78;5;73;1072;1943;2
Kraków;126101;5;93;6;87;1150;999;0
Kraków;126101;6;80;6;74;1423;1692;2
Kraków;126101;7;99;6;93;1697;1580;0
Nowy Sącz;126201;1;60;6;54;332;283;0
Nowy Sącz;126201;2;44;5;39;411;440;1
Nowy Sącz;126201;3;74;7;67;250;309;2
Nowy Sącz;126201;4;55;5;50;239;687;4
Tarnów;126301;1;60;6;54;240;434;9
Tarnów;126301;2;67;7;60;510;358;0
Tarnów;126301;3;68;7;61;339;339;0
Tarnów;126301;4;50;5;45;370;431;1
białobrzeski;140100;1;81;7;74;162;265;4
białobrzeski;140100;2;47;4;43;306;346;1
białobrzeski;140100;3;47;4;43;236;203;0
ciechanowski;140200;1;103;8;95;141;240;11
ciechanowski;140200;2;47;3;44;287;241;0
ciechanowski;140200;3;45;3;42;337;258;0
ciechanowski;140200;4;42;3;39;238;427;4
ciechanowski;140200;5;50;4;46;513;438;0
garwoliński;140300;1;45;4;41;309;418;2
garwoliński;140300;2;65;6;59;321;363;1
garwoliński;140300;3;29;3;26;334;738;2
garwoliński;140300;4;34;3;31;816;582;0
garwoliński;140300;5;28;3;25;610;540;0
garwoliński;140300;6;39;4;35;325;400;1
gostyniński;140400;1;62;7;55;218;251;1
gostyniński;140400;2;40;4;36;377;356;0
gostyniński;140400;3;53;6;47;498;269;0
grodziski;140500;1;74;10;64;142;667;16
grodziski;140500;2;35;6;29;260;326;1
grodziski;140500;3;37;5;32;427;682;1
grójecki;140600;1;43;5;38;479;529;1
grójecki;140600;2;33;4;29;562;411;0
grójecki;140600;3;36;4;32;499;468;0
grójecki;140600;4;34;4;30;484;531;1
grójecki;140600;5;33;4;29;646;391;0
kozienicki;140700;1;54;4;50;323;513;1
kozienicki;140700;2;75;6;69;404;404;0
kozienicki;140700;3;124;9;115;259;334;4
legionowski;140800;1;57;6;51;334;315;0
legionowski;140800;2;50;5;45;337;472;1
legionowski;140800;3;32;5;27;448;666;1
legionowski;140800;4;35;5;30;419;572;5
lipski;140900;1;50;5;45;204;271;2
lipski;140900;2;42;4;38;197;366;1
lipski;140900;3;29;3;26;460;262;0
lipski;140900;4;29;3;26;185;198;1
łosicki;141000;1;44;5;39;107;235;6
łosicki;141000;2;51;5;46;226;235;1
łosicki;141000;3;52;5;47;124;249;3
makowski;141100;1;29;4;25;247;243;0
makowski;141100;2;27;4;23;311;242;0
makowski;141100;3;21;3;18;300;286;0
makowski;141100;4;19;3;16;352;375;1
makowski;141100;5;20;3;17;469;276;0
miński;141200;1;41;7;34;365;663;3
miński;141200;2;23;4;19;515;386;0
miński;141200;3;23;4;19;324;622;5
miński;141200;4;22;4;18;511;376;0
miński;141200;5;14;3;11;669;981;1
miński;141200;6;29;5;24;496;615;1
mławski;141300;1;100;8;92;177;564;10
mławski;141300;2;34;3;31;369;408;1
mławski;141300;3;46;5;41;308;429;3
mławski;141300;4;31;3;28;386;364;0
nowodworski;141400;1;74;7;67;333;383;1
nowodworski;141400;2;38;5;33;399;436;1
nowodworski;141400;3;41;4;37;256;488;4
nowodworski;141400;4;35;3;32;425;603;3
ostrołęcki;141500;1;42;4;38;454;368;0
ostrołęcki;141500;2;44;4;40;299;290;0
ostrołęcki;141500;3;58;5;53;282;327;2
ostrołęcki;141500;4;41;4;37;388;367;0
ostrołęcki;141500;5;27;4;23;326;454;1
ostrowski;141600;1;82;6;76;243;409;4
ostrowski;141600;2;47;4;43;376;611;2
ostrowski;141600;3;76;6;70;312;377;2
ostrowski;141600;4;34;3;31;532;307;0
otwocki;141700;1;83;9;74;424;624;3
otwocki;141700;2;26;3;23;215;449;7
otwocki;141700;3;33;4;29;371;491;1
otwocki;141700;4;39;4;35;642;633;0
otwocki;141700;5;18;3;15;946;862;0
piaseczyński;141800;1;91;8;83;383;481;6
piaseczyński;141800;2;49;4;45;419;335;0
piaseczyński;141800;3;44;4;40;521;867;1
piaseczyński;141800;4;46;4;42;621;720;1
piaseczyński;141800;5;73;7;66;398;518;2
płocki;141900;1;35;4;31;314;319;1
płocki;141900;2;29;4;25;593;543;0
płocki;141900;3;32;3;29;687;509;0
płocki;141900;4;31;4;27;608;487;0
płocki;141900;5;29;3;26;318;477;1
płocki;141900;6;51;5;46;653;560;0
płoński;142000;1;59;5;54;414;458;1
płoński;142000;2;58;5;53;218;453;3
płoński;142000;3;35;3;32;521;461;0
płoński;142000;4;42;4;38;206;258;5
płoński;142000;5;38;4;34;356;464;3
pruszkowski;142100;1;47;10;37;407;432;1
pruszkowski;142100;2;15;4;11;599;599;0
pruszkowski;142100;3;29;5;24;679;528;0
pruszkowski;142100;4;29;4;25;362;1501;4
pruszkowski;142100;5;18;4;14;862;729;0
przasnyski;142200;1;50;5;45;345;392;1
przasnyski;142200;2;47;5;42;385;266;0
przasnyski;142200;3;64;7;57;257;373;3
przysuski;142300;1;50;5;45;285;298;1
przysuski;142300;2;32;4;28;223;309;4
przysuski;142300;3;18;3;15;606;353;0
przysuski;142300;4;47;5;42;298;349;1
pułtuski;142400;1;21;3;18;260;353;2
pułtuski;142400;2;17;3;14;295;415;3
pułtuski;142400;3;20;3;17;372;451;1
pułtuski;142400;4;60;8;52;293;340;3
radomski;142500;1;58;5;53;559;756;1
radomski;142500;2;33;3;30;527;379;0
radomski;142500;3;59;6;53;682;771;1
radomski;142500;4;45;4;41;660;528;0
radomski;142500;5;49;4;45;487;574;1
radomski;142500;6;53;5;48;548;465;0
siedlecki;142600;1;40;4;36;197;244;3
siedlecki;142600;2;29;3;26;585;347;0
siedlecki;142600;3;52;5;47;253;413;2
siedlecki;142600;4;36;4;32;430;412;0
siedlecki;142600;5;50;5;45;370;402;1
sierpecki;142700;1;77;6;71;154;319;7
sierpecki;142700;2;53;4;49;352;419;2
sierpecki;142700;3;39;3;36;223;376;2
sierpecki;142700;4;50;4;46;253;386;2
sochaczewski;142800;1;46;5;41;298;341;3
sochaczewski;142800;2;73;7;66;197;348;5
sochaczewski;142800;3;114;9;105;318;407;1
sokołowski;142900;1;52;5;47;230;298;2
sokołowski;142900;2;34;3;31;169;324;4
sokołowski;142900;3;32;3;29;315;367;1
sokołowski;142900;4;31;3;28;349;409;3
sokołowski;142900;5;30;3;27;385;291;0
szydłowiecki;143000;1;102;8;94;209;285;3
szydłowiecki;143000;2;35;3;32;249;310;3
szydłowiecki;143000;3;70;6;64;258;318;1
warszawski zachodni;143200;1;18;3;15;613;400;0
warszawski zachodni;143200;2;27;5;22;575;654;2
warszawski zachodni;143200;3;28;5;23;832;599;0
warszawski zachodni;143200;4;22;4;18;460;452;0
warszawski zachodni;143200;5;23;4;19;756;596;0
węgrowski;143300;1;39;4;35;189;230;1
węgrowski;143300;2;32;4;28;374;364;0
węgrowski;143300;3;38;5;33;301;362;2
węgrowski;143300;4;24;3;21;465;414;0
węgrowski;143300;5;24;3;21;293;324;1
wołomiński;143400;1;32;3;29;706;984;1
wołomiński;143400;2;31;3;28;788;456;0
wołomiński;143400;3;42;3;39;790;465;0
wołomiński;143400;4;71;5;66;330;617;7
wołomiński;143400;5;93;7;86;542;627;1
wołomiński;143400;6;61;5;56;580;543;0
wołomiński;143400;7;41;3;38;672;585;0
wyszkowski;143500;1;112;10;102;183;309;6
wyszkowski;143500;2;37;4;33;461;506;2
wyszkowski;143500;3;42;5;37;324;554;3
zwoleński;143600;1;54;4;50;236;335;1
zwoleński;143600;2;77;5;72;103;236;5
zwoleński;143600;3;93;6;87;146;310;2
żuromiński;143700;1;35;6;29;264;304;1
żuromiński;143700;2;34;5;29;250;339;1
żuromiński;143700;3;40;6;34;361;272;0
żyrardowski;143800;1;36;3;33;386;248;0
żyrardowski;143800;2;77;7;70;281;349;1
żyrardowski;143800;3;39;4;35;263;341;3
żyrardowski;143800;4;41;5;36;327;327;0
Ostrołęka;146101;1;91;7;84;139;253;4
Ostrołęka;146101;2;99;8;91;151;164;2
Ostrołęka;146101;3;101;8;93;120;269;3
Płock;146201;1;76;6;70;251;445;8
Płock;146201;2;89;7;82;433;504;1
Płock;146201;3;72;5;67;432;509;3
Płock;146201;4;90;7;83;398;375;0
Radom;146301;1;87;6;81;628;426;0
Radom;146301;2;76;5;71;477;634;1
Radom;146301;3;92;6;86;544;863;2
Radom;146301;4;96;6;90;688;638;0
Radom;146301;5;77;5;72;426;714;3
Siedlce;146401;1;66;6;60;257;359;2
Siedlce;146401;2;68;6;62;198;199;1
Siedlce;146401;3;58;5;53;336;383;1
Siedlce;146401;4;70;6;64;219;465;2
Warszawa;146501;1;114;7;107;2075;3366;1
Warszawa;146501;2;109;6;103;2909;2060;0
Warszawa;146501;3;120;8;112;1590;2122;3
Warszawa;146501;4;102;5;97;2672;2302;0
Warszawa;146501;5;117;7;110;2496;2459;0
Warszawa;146501;6;111;6;105;1816;2842;5
Warszawa;146501;7;123;8;115;3456;2297;0
Warszawa;146501;8;116;6;110;2569;2486;0
Warszawa;146501;9;125;7;118;3295;3186;0
brzeski;160100;1;108;9;99;248;266;1
brzeski;160100;2;59;5;54;323;402;3
brzeski;160100;3;39;4;35;215;286;5
brzeski;160100;4;38;3;35;249;267;1
głubczycki;160200;1;111;8;103;180;319;4
głubczycki;160200;2;96;6;90;147;253;6
głubczycki;160200;3;36;3;33;136;185;2
kędzierzyńsko-kozielski;160300;1;32;3;29;425;394;0
kędzierzyńsko-kozielski;160300;2;36;3;33;428;292;0
kędzierzyńsko-kozielski;160300;3;33;3;30;428;270;0
kędzierzyńsko-kozielski;160300;4;48;4;44;292;328;2
kędzierzyńsko-kozielski;160300;5;32;4;28;297;312;1
kędzierzyńsko-kozielski;160300;6;37;4;33;208;624;3
kluczborski;160400;1;38;3;35;224;151;0
kluczborski;160400;2;99;7;92;248;231;0
kluczborski;160400;3;58;5;53;241;301;1
kluczborski;160400;4;50;4;46;149;341;2
krapkowicki;160500;1;52;7;45;229;278;1
krapkowicki;160500;2;10;3;7;529;473;0
krapkowicki;160500;3;30;5;25;137;387;4
krapkowicki;160500;4;17;4;13;513;336;0
namysłowski;160600;1;87;6;81;247;246;0
namysłowski;160600;2;76;6;70;157;166;2
namysłowski;160600;3;58;5;53;193;289;3
nyski;160700;1;79;6;73;380;387;1
nyski;160700;2;66;5;61;516;593;1
nyski;160700;3;69;5;64;501;450;0
nyski;160700;4;68;5;63;403;428;1
nyski;160700;5;41;3;38;281;421;2
nyski;160700;6;37;3;34;232;267;1
oleski;160800;1;39;6;33;291;465;2
oleski;160800;2;30;4;26;182;173;0
oleski;160800;3;20;4;16;293;190;0
oleski;160800;4;40;5;35;233;357;1
opolski;160900;1;42;5;37;329;600;5
opolski;160900;2;41;4;37;239;542;2
opolski;160900;3;25;3;22;363;326;0
opolski;160900;4;32;4;28;554;326;0
opolski;160900;5;29;4;25;655;360;0
opolski;160900;6;39;5;34;196;409;9
prudnicki;161000;1;63;8;55;175;286;6
prudnicki;161000;2;35;4;31;303;276;0
prudnicki;161000;3;49;5;44;162;284;1
strzelecki;161100;1;76;9;67;214;268;6
strzelecki;161100;2;14;3;11;404;146;0
strzelecki;161100;3;15;3;12;422;377;0
strzelecki;161100;4;11;4;7;344;489;2
Opole;166101;1;55;5;50;373;365;0
Opole;166101;2;57;5;52;262;419;3
Opole;166101;3;60;5;55;374;407;1
Opole;166101;4;64;5;59;277;243;0
Opole;166101;5;55;5;50;289;499;2
bieszczadzki;180100;1;48;6;42;122;119;0
bieszczadzki;180100;2;46;6;40;115;113;0
bieszczadzki;180100;3;24;3;21;100;153;2
brzozowski;180200;1;72;8;64;295;333;1
brzozowski;180200;2;54;5;49;221;484;3
brzozowski;180200;3;54;6;48;328;547;3
dębicki;180300;1;85;9;76;334;539;4
dębicki;180300;2;26;3;23;525;629;2
dębicki;180300;3;46;5;41;488;534;2
dębicki;180300;4;43;5;38;281;348;3
dębicki;180300;5;29;3;26;916;448;0
jarosławski;180400;1;78;8;70;413;489;1
jarosławski;180400;2;48;6;42;553;582;2
jarosławski;180400;3;48;5;43;559;628;1
jarosławski;180400;4;51;6;45;398;570;5
jasielski;180500;1;56;7;49;520;472;0
jasielski;180500;2;23;3;20;474;641;1
jasielski;180500;3;42;6;36;504;493;0
jasielski;180500;4;23;3;20;603;541;0
jasielski;180500;5;29;4;25;398;401;1
kolbuszowski;180600;1;61;8;53;316;294;0
kolbuszowski;180600;2;17;4;13;440;409;0
kolbuszowski;180600;3;23;4;19;341;391;1
kolbuszowski;180600;4;22;3;19;417;331;0
krośnieński;180700;1;28;3;25;351;606;2
krośnieński;180700;2;32;3;29;618;585;0
krośnieński;180700;3;59;6;53;356;375;1
krośnieński;180700;4;35;3;32;309;453;4
krośnieński;180700;5;39;4;35;305;400;2
krośnieński;180700;6;34;4;30;430;543;2
leżajski;180800;1;52;4;48;209;399;2
leżajski;180800;2;43;4;39;360;358;0
leżajski;180800;3;62;5;57;307;450;1
leżajski;180800;4;73;6;67;311;355;1
lubaczowski;180900;1;48;4;44;212;330;3
lubaczowski;180900;2;74;7;67;358;436;2
lubaczowski;180900;3;62;6;56;302;410;2
łańcucki;181000;1;44;4;40;356;383;1
łańcucki;181000;2;67;7;60;257;348;4
łańcucki;181000;3;44;4;40;214;357;2
łańcucki;181000;4;33;4;29;483;559;2
mielecki;181100;1;62;6;56;370;502;3
mielecki;181100;2;46;5;41;567;458;0
mielecki;181100;3;30;4;26;514;493;0
mielecki;181100;4;48;5;43;588;617;2
mielecki;181100;5;49;5;44;393;484;2
niżański;181200;1;24;3;21;428;412;0
niżański;181200;2;40;4;36;328;528;1
niżański;181200;3;28;3;25;377;282;0
niżański;181200;4;71;6;65;197;295;4
niżański;181200;5;39;3;36;175;182;2
przemyski;181300;1;38;3;35;264;352;1
przemyski;181300;2;41;3;38;305;495;2
przemyski;181300;3;73;5;68;313;306;0
przemyski;181300;4;66;5;61;346;419;2
przemyski;181300;5;36;3;33;281;184;0
przeworski;181400;1;21;3;18;413;449;2
przeworski;181400;2;63;6;57;323;328;1
przeworski;181400;3;46;4;42;400;369;0
przeworski;181400;4;24;3;21;604;524;0
przeworski;181400;5;54;5;49;332;347;2
ropczycko-sędziszowski;181500;1;77;7;70;228;493;3
ropczycko-sędziszowski;181500;2;58;6;52;353;462;4
ropczycko-sędziszowski;181500;3;61;6;55;368;346;0
rzeszowski;181600;1;26;4;22;799;775;0
rzeszowski;181600;2;25;3;22;520;1297;2
rzeszowski;181600;3;32;5;27;469;773;2
rzeszowski;181600;4;21;3;18;709;414;0
rzeszowski;181600;5;23;4;19;439;593;3
rzeszowski;181600;6;23;3;20;333;589;2
rzeszowski;181600;7;23;3;20;748;501;0
rzeszowski;181600;8;24;4;20;504;553;1
sanocki;181700;1;67;4;63;135;392;10
sanocki;181700;2;69;4;65;227;366;4
sanocki;181700;3;153;9;144;254;493;4
sanocki;181700;4;74;4;70;329;292;0
stalowowolski;181800;1;72;9;63;346;381;1
stalowowolski;181800;2;40;5;35;445;399;0
stalowowolski;181800;3;31;4;27;409;394;0
stalowowolski;181800;4;34;5;29;596;504;0
strzyżowski;181900;1;36;4;32;322;280;0
strzyżowski;181900;2;28;3;25;223;201;0
strzyżowski;181900;3;28;3;25;449;380;0
strzyżowski;181900;4;53;6;47;313;284;0
strzyżowski;181900;5;35;3;32;190;251;3
tarnobrzeski;182000;1;38;4;34;104;232;4
tarnobrzeski;182000;2;44;4;40;315;249;0
tarnobrzeski;182000;3;31;3;28;414;407;0
tarnobrzeski;182000;4;66;6;60;174;283;3
leski;182100;1;20;3;17;178;199;1
leski;182100;2;43;6;37;151;160;2
leski;182100;3;20;3;17;168;157;0
leski;182100;4;22;3;19;172;192;1
Krosno;186101;1;70;7;63;185;200;1
Krosno;186101;2;56;7;49;213;220;1
Krosno;186101;3;57;7;50;180;158;0
Przemyśl;186201;1;94;7;87;160;309;7
Przemyśl;186201;2;74;6;68;181;283;4
Przemyśl;186201;3;68;5;63;201;233;1
Przemyśl;186201;4;63;5;58;193;192;0
Rzeszów;186301;1;85;7;78;570;834;1
Rzeszów;186301;2;67;6;61;557;529;0
Rzeszów;186301;3;65;6;59;568;676;2
Rzeszów;186301;4;73;6;67;603;649;1
Tarnobrzeg;186401;1;59;6;53;176;182;1
Tarnobrzeg;186401;2;50;5;45;217;234;1
Tarnobrzeg;186401;3;50;5;45;161;202;3
Tarnobrzeg;186401;4;50;5;45;221;294;1
augustowski;200100;1;87;9;78;168;236;4
augustowski;200100;2;38;3;35;245;280;1
augustowski;200100;3;26;3;23;309;314;1
augustowski;200100;4;40;4;36;324;218;0
białostocki;200200;1;33;5;28;662;768;1
białostocki;200200;2;26;4;22;524;770;1
białostocki;200200;3;33;5;28;381;442;1
białostocki;200200;4;21;3;18;777;862;1
białostocki;200200;5;33;5;28;560;459;0
białostocki;200200;6;22;3;19;614;486;0
bielski;200300;1;66;8;58;286;424;2
bielski;200300;2;63;7;56;430;429;0
bielski;200300;3;35;4;31;304;333;1
grajewski;200400;1;54;7;47;205;264;2
grajewski;200400;2;24;4;20;302;244;0
grajewski;200400;3;33;6;27;253;380;3
hajnowski;200500;1;60;8;52;314;247;0
hajnowski;200500;2;20;3;17;275;449;3
hajnowski;200500;3;12;3;9;375;351;0
hajnowski;200500;4;19;3;16;415;326;0
kolneński;200600;1;69;5;64;174;230;1
kolneński;200600;2;43;4;39;148;268;5
kolneński;200600;3;56;4;52;221;241;1
kolneński;200600;4;53;4;49;231;288;1
łomżyński;200700;1;26;3;23;284;247;0
łomżyński;200700;2;27;3;24;356;280;0
łomżyński;200700;3;25;3;22;190;321;6
łomżyński;200700;4;30;3;27;268;223;0
łomżyński;200700;5;39;5;34;286;379;1
moniecki;200800;1;31;4;27;265;224;0
moniecki;200800;2;25;3;22;220;305;3
moniecki;200800;3;32;4;28;219;207;0
moniecki;200800;4;48;6;42;159;289;6
sejneński;200900;1;39;4;35;111;251;1
sejneński;200900;2;48;5;43;154;184;1
sejneński;200900;3;31;3;28;135;173;1
sejneński;200900;4;12;3;9;129;107;0
siemiatycki;201000;1;50;6;44;240;359;2
siemiatycki;201000;2;45;5;40;266;237;0
siemiatycki;201000;3;47;6;41;187;354;6
sokólski;201100;1;21;3;18;421;428;1
sokólski;201100;2;20;4;16;325;484;2
sokólski;201100;3;30;5;25;458;530;1
sokólski;201100;4;57;7;50;285;383;4
suwalski;201200;1;38;5;33;199;233;2
suwalski;201200;2;24;3;21;233;394;1
suwalski;201200;3;25;3;22;221;303;2
suwalski;201200;4;30;4;26;203;253;1
wysokomazowiecki;201300;1;20;3;17;385;305;0
wysokomazowiecki;201300;2;21;3;18;353;332;0
wysokomazowiecki;201300;3;20;3;17;425;476;1
wysokomazowiecki;201300;4;30;4;26;222;299;1
wysokomazowiecki;201300;5;19;3;16;322;336;1
wysokomazowiecki;201300;6;20;3;17;474;187;0
zambrowski;201400;1;80;9;71;172;250;3
zambrowski;201400;2;45;5;40;234;273;2
zambrowski;201400;3;16;3;13;393;302;0
Białystok;206101;1;45;5;40;666;1402;2
Białystok;206101;2;55;6;49;657;677;2
Białystok;206101;3;47;5;42;1223;1117;0
Białystok;206101;4;47;5;42;1009;866;0
Białystok;206101;5;61;7;54;633;1027;2
Łomża;206201;1;63;5;58;168;177;1
Łomża;206201;2;50;5;45;168;240;1
Łomża;206201;3;81;7;74;173;184;2
Łomża;206201;4;60;6;54;180;267;1
Suwałki;206301;1;55;5;50;172;248;2
Suwałki;206301;2;66;6;60;221;238;1
Suwałki;206301;3;71;6;65;182;246;2
Suwałki;206301;4;68;6;62;168;207;5
bytowski;220100;1;60;6;54;261;277;2
bytowski;220100;2;50;5;45;474;243;0
bytowski;220100;3;39;4;35;500;502;1
bytowski;220100;4;40;4;36;439;651;1
chojnicki;220200;1;85;9;76;341;403;2
chojnicki;220200;2;41;4;37;220;455;6
chojnicki;220200;3;29;3;26;782;300;0
chojnicki;220200;4;37;5;32;467;438;0
człuchowski;220300;1;32;4;28;330;530;1
człuchowski;220300;2;17;3;14;369;436;1
człuchowski;220300;3;18;3;15;425;379;0
człuchowski;220300;4;12;3;9;397;431;1
człuchowski;220300;5;19;4;15;649;359;0
gdański;220400;1;38;6;32;485;538;2
gdański;220400;2;24;4;20;321;305;0
gdański;220400;3;19;3;16;251;392;3
gdański;220400;4;25;4;21;372;356;0
gdański;220400;5;29;4;25;570;363;0
kartuski;220500;1;45;6;39;566;578;2
kartuski;220500;2;59;6;53;404;636;3
kartuski;220500;3;53;7;46;708;751;1
kartuski;220500;4;39;4;35;369;541;4
kościerski;220600;1;48;6;42;562;423;0
kościerski;220600;2;32;4;28;364;379;1
kościerski;220600;3;30;4;26;269;343;3
kościerski;220600;4;40;5;35;183;357;7
kwidzyński;220700;1;66;10;56;163;302;10
kwidzyński;220700;2;22;3;19;351;304;0
kwidzyński;220700;3;24;4;20;280;299;1
kwidzyński;220700;4;28;4;24;228;297;3
lęborski;220800;1;96;10;86;169;317;10
lęborski;220800;2;31;3;28;408;354;0
lęborski;220800;3;56;6;50;232;338;5
malborski;220900;1;43;5;38;307;460;1
malborski;220900;2;47;6;41;216;298;2
malborski;220900;3;64;8;56;357;341;0
nowodworski;221000;1;119;8;111;163;254;5
nowodworski;221000;2;90;7;83;199;333;4
pucki;221100;1;43;6;37;598;447;0
pucki;221100;2;18;3;15;263;409;3
pucki;221100;3;79;10;69;302;448;5
słupski;221200;1;22;3;19;463;617;1
słupski;221200;2;32;5;27;348;355;1
słupski;221200;3;30;5;25;374;449;1
słupski;221200;4;29;4;25;546;446;0
słupski;221200;5;28;4;24;229;314;3
starogardzki;221300;1;28;3;25;478;527;1
starogardzki;221300;2;87;10;77;298;281;0
starogardzki;221300;3;53;6;47;406;630;1
starogardzki;221300;4;27;3;24;634;539;0
starogardzki;221300;5;27;3;24;480;489;1
tczewski;221400;1;46;5;41;410;398;0
tczewski;221400;2;71;7;64;211;476;8
tczewski;221400;3;40;4;36;226;287;3
tczewski;221400;4;28;3;25;400;389;0
tczewski;221400;5;40;4;36;201;318;3
wejherowski;221500;1;20;3;17;482;733;3
wejherowski;221500;2;55;7;48;661;635;0
wejherowski;221500;3;64;7;57;518;575;1
wejherowski;221500;4;21;3;18;641;664;1
wejherowski;221500;5;35;5;30;900;807;0
wejherowski;221500;6;29;4;25;528;608;2
sztumski;221600;1;34;4;30;184;220;1
sztumski;221600;2;24;3;21;240;373;2
sztumski;221600;3;20;3;17;152;183;2
sztumski;221600;4;64;7;57;137;225;5
Gdańsk;226101;1;61;6;55;744;934;1
Gdańsk;226101;2;87;8;79;1018;1474;2
Gdańsk;226101;3;51;5;46;1585;1662;1
Gdańsk;226101;4;56;5;51;1841;1131;0
Gdańsk;226101;5;58;5;53;1129;1139;1
Gdańsk;226101;6;69;5;64;775;1396;2
Gdynia;226201;1;47;6;41;771;926;2
Gdynia;226201;2;54;6;48;847;907;1
Gdynia;226201;3;54;6;48;729;1268;1
Gdynia;226201;4;46;5;41;1275;1355;1
Gdynia;226201;5;40;5;35;685;1006;3
Słupsk;226301;1;106;7;99;285;355;2
Słupsk;226301;2;76;5;71;206;206;0
Słupsk;226301;3;89;6;83;277;311;1
Słupsk;226301;4;82;5;77;228;517;4
Sopot;226401;1;50;6;44;204;295;2
Sopot;226401;2;50;5;45;260;258;0
Sopot;226401;3;42;5;37;299;285;0
Sopot;226401;4;47;5;42;163;241;2
będziński;240100;1;52;6;46;250;685;4
będziński;240100;2;43;5;38;358;484;2
będziński;240100;3;51;6;45;384;855;3
będziński;240100;4;41;5;36;388;525;5
będziński;240100;5;44;5;39;689;693;1
bielski;240200;1;40;5;35;528;482;0
bielski;240200;2;32;4;28;395;710;4
bielski;240200;3;61;8;53;498;490;0
bielski;240200;4;41;5;36;612;701;2
bielski;240200;5;38;5;33;411;380;0
cieszyński;240300;1;53;6;47;524;859;1
cieszyński;240300;2;29;3;26;463;506;1
cieszyński;240300;3;41;4;37;354;302;0
cieszyński;240300;4;36;4;32;361;344;0
cieszyński;240300;5;42;4;38;881;381;0
cieszyński;240300;6;40;4;36;499;436;0
cieszyński;240300;7;35;4;31;405;474;1
częstochowski;240400;1;54;4;50;352;398;1
częstochowski;240400;2;54;4;50;335;329;0
częstochowski;240400;3;54;4;50;496;582;1
częstochowski;240400;4;42;3;39;394;373;0
częstochowski;240400;5;55;4;51;356;347;0
częstochowski;240400;6;42;3;39;573;803;1
częstochowski;240400;7;40;3;37;596;563;0
gliwicki;240500;1;76;8;68;326;420;3
gliwicki;240500;2;28;4;24;343;295;0
gliwicki;240500;3;37;4;33;349;491;2
gliwicki;240500;4;27;4;23;606;498;0
gliwicki;240500;5;15;3;12;458;574;1
kłobucki;240600;1;47;4;43;405;333;0
kłobucki;240600;2;46;4;42;355;395;1
kłobucki;240600;3;46;4;42;162;226;6
kłobucki;240600;4;57;5;52;307;458;2
kłobucki;240600;5;47;4;43;237;290;3
lubliniecki;240700;1;54;6;48;235;385;2
lubliniecki;240700;2;42;5;37;335;346;2
lubliniecki;240700;3;27;3;24;345;303;0
lubliniecki;240700;4;42;5;37;192;407;5
mikołowski;240800;1;82;9;73;371;343;0
mikołowski;240800;2;50;5;45;281;353;1
mikołowski;240800;3;38;4;34;259;298;2
mikołowski;240800;4;26;3;23;466;405;0
myszkowski;240900;1;103;9;94;298;488;1
myszkowski;240900;2;56;4;52;257;229;0
myszkowski;240900;3;36;3;33;328;363;1
myszkowski;240900;4;41;3;38;455;504;2
pszczyński;241000;1;37;5;32;567;610;1
pszczyński;241000;2;18;3;15;623;588;0
pszczyński;241000;3;47;6;41;508;481;0
pszczyński;241000;4;37;5;32;376;443;1
pszczyński;241000;5;29;4;25;412;365;0
raciborski;241100;1;30;4;26;200;347;4
raciborski;241100;2;28;4;24;313;285;0
raciborski;241100;3;31;4;27;236;392;5
raciborski;241100;4;38;5;33;488;387;0
raciborski;241100;5;42;6;36;350;370;1
rybnicki;241200;1;24;3;21;368;305;0
rybnicki;241200;2;36;4;32;219;338;2
rybnicki;241200;3;28;3;25;383;340;0
rybnicki;241200;4;48;6;42;418;384;0
rybnicki;241200;5;24;3;21;418;345;0
tarnogórski;241300;1;46;5;41;553;742;1
tarnogórski;241300;2;30;3;27;553;749;1
tarnogórski;241300;3;30;3;27;418;253;0
tarnogórski;241300;4;20;3;17;727;578;0
tarnogórski;241300;5;78;7;71;289;621;3
tarnogórski;241300;6;47;4;43;456;395;0
bieruńsko-lędziński;241400;1;29;6;23;260;481;2
bieruńsko-lędziński;241400;2;33;5;28;294;370;2
bieruńsko-lędziński;241400;3;15;6;9;681;745;1
wodzisławski;241500;1;50;4;46;377;362;0
wodzisławski;241500;2;36;3;33;496;299;0
wodzisławski;241500;3;49;4;45;354;410;2
wodzisławski;241500;4;96;8;88;342;516;7
wodzisławski;241500;5;44;4;40;420;647;2
wodzisławski;241500;6;48;4;44;359;388;1
zawierciański;241600;1;31;3;28;509;438;0
zawierciański;241600;2;47;5;42;362;415;3
zawierciański;241600;3;35;3;32;289;348;2
zawierciański;241600;4;34;3;31;361;515;2
zawierciański;241600;5;43;4;39;427;645;2
zawierciański;241600;6;34;3;31;737;508;0
zawierciański;241600;7;42;4;38;201;523;8
żywiecki;241700;1;77;6;71;359;459;5
żywiecki;241700;2;51;4;47;533;528;0
żywiecki;241700;3;58;5;53;675;574;0
żywiecki;241700;4;35;3;32;557;668;2
żywiecki;241700;5;66;5;61;432;504;3
żywiecki;241700;6;46;4;42;641;722;1
Bielsko-Biała;246101;1;55;5;50;794;775;0
Bielsko-Biała;246101;2;60;5;55;290;680;9
Bielsko-Biała;246101;3;55;5;50;329;738;4
Bielsko-Biała;246101;4;54;5;49;601;1033;2
Bielsko-Biała;246101;5;55;5;50;354;764;3
Bytom;246201;1;64;5;59;292;533;3
Bytom;246201;2;60;5;55;697;492;0
Bytom;246201;3;64;5;59;340;410;1
Bytom;246201;4;60;5;55;234;388;6
Bytom;246201;5;62;5;57;510;601;1
Chorzów;246301;1;72;7;65;241;352;6
Chorzów;246301;2;56;6;50;237;529;3
Chorzów;246301;3;62;7;55;427;423;0
Chorzów;246301;4;52;5;47;406;327;0
Częstochowa;246401;1;58;5;53;581;531;0
Częstochowa;246401;2;61;5;56;958;939;0
Częstochowa;246401;3;71;6;65;732;641;0
Częstochowa;246401;4;85;7;78;535;730;4
Częstochowa;246401;5;60;5;55;706;697;0
Dąbrowa Górnicza;246501;1;63;5;58;453;652;1
Dąbrowa Górnicza;246501;2;64;5;59;228;432;3
Dąbrowa Górnicza;246501;3;63;5;58;311;356;1
Dąbrowa Górnicza;246501;4;64;5;59;319;437;2
Dąbrowa Górnicza;246501;5;64;5;59;397;396;0
Gliwice;246601;1;69;6;63;384;628;2
Gliwice;246601;2;77;7;70;489;988;2
Gliwice;246601;3;56;5;51;596;457;0
Gliwice;246601;4;82;7;75;597;770;1
Jastrzębie-Zdrój;246701;1;88;7;81;334;357;2
Jastrzębie-Zdrój;246701;2;95;8;87;229;268;1
Jastrzębie-Zdrój;246701;3;91;8;83;175;348;6
Jaworzno;246801;1;63;8;55;233;359;5
Jaworzno;246801;2;39;5;34;423;401;0
Jaworzno;246801;3;40;5;35;370;354;0
Jaworzno;246801;4;40;5;35;296;365;2
Katowice;246901;1;88;7;81;974;823;0
Katowice;246901;2;60;5;55;563;652;1
Katowice;246901;3;59;5;54;703;970;2
Katowice;246901;4;82;6;76;640;904;3
Katowice;246901;5;60;5;55;1062;1492;1
Mysłowice;247001;1;77;5;72;204;245;2
Mysłowice;247001;2;86;7;79;278;325;1
Mysłowice;247001;3;69;5;64;267;456;1
Mysłowice;247001;4;70;6;64;241;325;3
Piekary Śląskie;247101;1;51;8;43;193;256;3
Piekary Śląskie;247101;2;43;7;36;154;195;3
Piekary Śląskie;247101;3;49;8;41;343;289;0
Ruda Śląska;247201;1;96;8;88;505;485;0
Ruda Śląska;247201;2;64;6;58;306;259;0
Ruda Śląska;247201;3;73;6;67;504;461;0
Ruda Śląska;247201;4;64;5;59;538;387;0
Rybnik;247301;1;71;6;65;411;505;2
Rybnik;247301;2;77;7;70;370;476;1
Rybnik;247301;3;68;6;62;438;440;1
Rybnik;247301;4;70;6;64;470;488;2
Siemianowice Śląskie;247401;1;74;6;68;173;174;1
Siemianowice Śląskie;247401;2;63;5;58;227;192;0
Siemianowice Śląskie;247401;3;72;6;66;239;368;1
Siemianowice Śląskie;247401;4;71;6;65;163;205;4
Sosnowiec;247501;1;49;5;44;746;786;1
Sosnowiec;247501;2;69;7;62;654;574;0
Sosnowiec;247501;3;49;5;44;670;519;0
Sosnowiec;247501;4;58;6;52;319;692;5
Sosnowiec;247501;5;49;5;44;535;609;2
Świętochłowice;247601;1;60;6;54;154;259;1
Świętochłowice;247601;2;60;6;54;192;227;3
Świętochłowice;247601;3;65;6;59;127;173;3
Świętochłowice;247601;4;57;5;52;136;147;1
Tychy;247701;1;67;5;62;417;353;0
Tychy;247701;2;66;5;61;332;409;2
Tychy;247701;3;70;5;65;382;406;2
Tychy;247701;4;59;5;54;465;437;0
Tychy;247701;5;68;5;63;297;430;2
Zabrze;247801;1;45;6;39;352;460;3
Zabrze;247801;2;59;6;53;477;631;1
Zabrze;247801;3;53;7;46;368;417;1
Zabrze;247801;4;60;6;54;536;510;0
Żory;247901;1;61;6;55;121;288;7
Żory;247901;2;55;5;50;239;236;0
Żory;247901;3;59;6;53;148;144;0
Żory;247901;4;56;6;50;226;234;1
buski;260100;1;73;8;65;428;389;0
buski;260100;2;25;4;21;654;538;0
buski;260100;3;28;4;24;329;435;1
buski;260100;4;22;3;19;776;647;0
jędrzejowski;260200;1;64;7;57;409;419;1
jędrzejowski;260200;2;26;3;23;322;392;3
jędrzejowski;260200;3;17;3;14;628;559;0
jędrzejowski;260200;4;37;5;32;330;366;3
jędrzejowski;260200;5;18;3;15;591;432;0
kazimierski;260300;1;33;3;30;243;231;0
kazimierski;260300;2;61;5;56;160;241;2
kazimierski;260300;3;73;7;66;188;286;4
kielecki;260400;1;41;4;37;836;1033;1
kielecki;260400;2;48;5;43;573;585;2
kielecki;260400;3;46;5;41;572;823;1
kielecki;260400;4;39;4;35;783;1027;1
kielecki;260400;5;37;4;33;655;583;0
kielecki;260400;6;37;4;33;719;674;0
kielecki;260400;7;24;3;21;625;880;2
konecki;260500;1;108;9;99;369;525;3
konecki;260500;2;60;5;55;297;342;2
konecki;260500;3;49;4;45;347;470;2
konecki;260500;4;30;3;27;378;508;2
opatowski;260600;1;49;5;44;334;329;0
opatowski;260600;2;50;6;44;260;241;0
opatowski;260600;3;58;6;52;362;356;0
ostrowiecki;260700;1;50;4;46;198;334;5
ostrowiecki;260700;2;50;4;46;476;338;0
ostrowiecki;260700;3;51;4;47;310;361;1
ostrowiecki;260700;4;39;3;36;297;295;0
ostrowiecki;260700;5;65;5;60;572;570;0
ostrowiecki;260700;6;38;3;35;362;530;3
pińczowski;260800;1;89;9;80;244;285;1
pińczowski;260800;2;70;8;62;221;327;4
sandomierski;260900;1;69;6;63;302;438;2
sandomierski;260900;2;27;3;24;615;813;1
sandomierski;260900;3;26;3;23;331;450;1
sandomierski;260900;4;55;5;50;405;438;1
sandomierski;260900;5;39;4;35;490;424;0
skarżyski;261000;1;68;6;62;305;356;1
skarżyski;261000;2;77;7;70;313;470;3
skarżyski;261000;3;72;8;64;481;442;0
starachowicki;261100;1;60;5;55;272;450;2
starachowicki;261100;2;36;3;33;302;472;1
starachowicki;261100;3;47;4;43;347;708;1
starachowicki;261100;4;40;4;36;428;843;2
starachowicki;261100;5;49;5;44;316;543;2
staszowski;261200;1;94;7;87;443;348;0
staszowski;261200;2;49;4;45;279;471;4
staszowski;261200;3;35;3;32;339;294;0
staszowski;261200;4;60;5;55;284;402;2
włoszczowski;261300;1;78;7;71;298;299;1
włoszczowski;261300;2;91;6;85;209;236;2
włoszczowski;261300;3;50;4;46;277;284;1
Kielce;266101;1;65;5;60;1017;898;0
Kielce;266101;2;75;5;70;647;789;1
Kielce;266101;3;69;5;64;667;864;1
Kielce;266101;4;70;5;65;863;739;0
Kielce;266101;5;70;5;65;605;693;3
bartoszycki;280100;1;111;8;103;218;260;3
bartoszycki;280100;2;29;3;26;294;197;0
bartoszycki;280100;3;42;4;38;239;348;3
bartoszycki;280100;4;54;4;50;180;287;4
braniewski;280200;1;117;9;108;192;228;5
braniewski;280200;2;49;4;45;75;210;8
braniewski;280200;3;48;4;44;285;297;1
działdowski;280300;1;82;6;76;205;370;3
działdowski;280300;2;56;4;52;204;235;3
działdowski;280300;3;73;5;68;199;262;2
działdowski;280300;4;49;4;45;215;343;4
elbląski;280400;1;53;6;47;137;277;6
elbląski;280400;2;33;4;29;251;193;0
elbląski;280400;3;32;4;28;275;296;1
elbląski;280400;4;28;3;25;329;429;1
ełcki;280500;1;39;4;35;276;277;1
ełcki;280500;2;29;3;26;234;362;2
ełcki;280500;3;30;3;27;294;440;1
ełcki;280500;4;29;3;26;382;292;0
ełcki;280500;5;42;4;38;274;345;2
ełcki;280500;6;34;4;30;263;330;2
giżycki;280600;1;104;9;95;62;244;27
giżycki;280600;2;44;4;40;191;314;4
giżycki;280600;3;41;4;37;314;317;1
iławski;280700;1;73;8;65;294;344;2
iławski;280700;2;75;7;68;235;358;3
iławski;280700;3;59;6;53;339;353;1
kętrzyński;280800;1;109;8;101;273;388;1
kętrzyński;280800;2;43;3;40;186;222;1
kętrzyński;280800;3;76;5;71;191;276;2
kętrzyński;280800;4;47;3;44;372;277;0
lidzbarski;280900;1;61;6;55;178;164;0
lidzbarski;280900;2;45;4;41;254;336;2
lidzbarski;280900;3;79;7;72;116;221;5
mrągowski;281000;1;89;7;82;160;227;3
mrągowski;281000;2;30;3;27;206;198;0
mrągowski;281000;3;28;3;25;179;245;4
mrągowski;281000;4;31;4;27;239;256;2
nidzicki;281100;1;98;9;89;227;212;0
nidzicki;281100;2;26;3;23;290;170;0
nidzicki;281100;3;27;3;24;171;367;3
nowomiejski;281200;1;42;4;38;151;147;0
nowomiejski;281200;2;35;3;32;235;186;0
nowomiejski;281200;3;29;3;26;201;202;1
nowomiejski;281200;4;36;3;33;317;165;0
nowomiejski;281200;5;39;4;35;243;210;0
olecki;281300;1;60;6;54;126;180;3
olecki;281300;2;101;9;92;137;157;1
olsztyński;281400;1;33;3;30;395;519;1
olsztyński;281400;2;37;4;33;388;421;1
olsztyński;281400;3;34;3;31;402;389;0
olsztyński;281400;4;37;4;33;453;546;1
olsztyński;281400;5;52;6;46;343;483;3
olsztyński;281400;6;32;3;29;408;421;1
ostródzki;281500;1;74;7;67;256;244;0
ostródzki;281500;2;50;5;45;349;692;3
ostródzki;281500;3;33;4;29;373;333;0
ostródzki;281500;4;31;3;28;761;329;0
ostródzki;281500;5;33;4;29;398;365;0
piski;281600;1;53;4;49;200;237;1
piski;281600;2;61;5;56;247;399;2
piski;281600;3;110;8;102;291;416;2
szczycieński;281700;1;94;7;87;214;427;6
szczycieński;281700;2;43;3;40;172;221;3
szczycieński;281700;3;35;3;32;442;301;0
szczycieński;281700;4;38;3;35;243;257;1
szczycieński;281700;5;43;3;40;359;252;0
gołdapski;281800;1;34;4;30;182;208;1
gołdapski;281800;2;60;7;53;100;176;7
gołdapski;281800;3;33;4;29;118;125;1
węgorzewski;281900;1;55;7;48;80;111;5
węgorzewski;281900;2;28;4;24;97;124;2
węgorzewski;281900;3;29;4;25;172;212;1
Elbląg;286101;1;58;5;53;399;362;0
Elbląg;286101;2;65;5;60;468;385;0
Elbląg;286101;3;69;5;64;230;337;3
Elbląg;286101;4;57;5;52;260;337;2
Elbląg;286101;5;67;5;62;285;288;1
Olsztyn;286201;1;65;5;60;654;529;0
Olsztyn;286201;2;87;7;80;490;764;2
Olsztyn;286201;3;81;6;75;83;544;28
Olsztyn;286201;4;86;7;79;489;538;2
chodzieski;300100;1;51;7;44;203;301;2
chodzieski;300100;2;15;3;12;278;215;0
chodzieski;300100;3;18;3;15;179;156;0
chodzieski;300100;4;22;4;18;370;445;1
czarnkowsko-trzcianecki;300200;1;58;5;53;323;376;2
czarnkowsko-trzcianecki;300200;2;30;3;27;459;303;0
czarnkowsko-trzcianecki;300200;3;41;4;37;134;574;5
czarnkowsko-trzcianecki;300200;4;55;6;49;404;313;0
czarnkowsko-trzcianecki;300200;5;34;3;31;476;228;0
gnieźnieński;300300;1;66;6;60;689;538;0
gnieźnieński;300300;2;76;7;69;190;342;6
gnieźnieński;300300;3;36;3;33;172;306;4
gnieźnieński;300300;4;29;3;26;500;369;0
gnieźnieński;300300;5;48;4;44;415;376;0
gnieźnieński;300300;6;47;4;43;377;664;4
gostyński;300400;1;43;7;36;200;491;4
gostyński;300400;2;29;4;25;319;514;1
gostyński;300400;3;21;3;18;363;439;1
gostyński;300400;4;35;5;30;216;651;4
grodziski;300500;1;72;7;65;103;287;8
grodziski;300500;2;41;4;37;348;338;0
grodziski;300500;3;51;6;45;182;298;4
jarociński;300600;1;82;7;75;235;372;2
jarociński;300600;2;56;5;51;308;385;1
jarociński;300600;3;36;3;33;310;278;0
jarociński;300600;4;47;4;43;262;368;2
kaliski;300700;1;47;4;43;389;394;1
kaliski;300700;2;59;5;54;231;265;1
kaliski;300700;3;35;3;32;234;244;1
kaliski;300700;4;57;5;52;309;412;1
kaliski;300700;5;47;4;43;407;379;0
kępiński;300800;1;86;7;79;209;409;4
kępiński;300800;2;80;6;74;193;232;2
kępiński;300800;3;46;4;42;300;459;1
kolski;300900;1;66;6;60;280;310;3
kolski;300900;2;37;3;34;408;244;0
kolski;300900;3;30;3;27;439;378;0
kolski;300900;4;38;3;35;774;627;0
kolski;300900;5;32;3;29;267;604;1
kolski;300900;6;34;3;31;610;353;0
koniński;301000;1;33;3;30;229;440;5
koniński;301000;2;46;4;42;327;271;0
koniński;301000;3;56;5;51;619;510;0
koniński;301000;4;46;4;42;350;794;4
koniński;301000;5;66;6;60;332;392;3
koniński;301000;6;34;3;31;399;409;1
kościański;301100;1;65;6;59;224;475;3
kościański;301100;2;65;6;59;345;404;1
kościański;301100;3;35;3;32;268;242;0
kościański;301100;4;38;4;34;333;298;0
krotoszyński;301200;1;96;10;86;250;440;5
krotoszyński;301200;2;42;5;37;182;273;5
krotoszyński;301200;3;35;4;31;380;308;0
leszczyński;301300;1;24;3;21;126;129;1
leszczyński;301300;2;38;4;34;294;625;2
leszczyński;301300;3;30;3;27;265;201;0
leszczyński;301300;4;24;3;21;290;225;0
leszczyński;301300;5;39;4;35;160;205;2
międzychodzki;301400;1;52;8;44;161;221;1
międzychodzki;301400;2;12;3;9;389;350;0
międzychodzki;301400;3;24;4;20;220;230;1
nowotomyski;301500;1;31;5;26;392;428;2
nowotomyski;301500;2;34;4;30;360;278;0
nowotomyski;301500;3;49;6;43;455;407;0
nowotomyski;301500;4;27;4;23;115;323;10
obornicki;301600;1;136;10;126;234;324;1
obornicki;301600;2;91;7;84;208;311;4
ostrowski;301700;1;39;4;35;566;304;0
ostrowski;301700;2;48;5;43;560;650;1
ostrowski;301700;3;38;4;34;671;562;0
ostrowski;301700;4;35;4;31;511;606;1
ostrowski;301700;5;50;5;45;415;496;1
ostrowski;301700;6;40;5;35;616;943;2
ostrzeszowski;301800;1;69;9;60;228;297;4
ostrzeszowski;301800;2;56;8;48;381;433;1
pilski;301900;1;26;3;23;432;579;1
pilski;301900;2;38;4;34;636;682;1
pilski;301900;3;27;3;24;620;429;0
pilski;301900;4;34;4;30;388;571;1
pilski;301900;5;35;4;31;661;694;1
pilski;301900;6;28;3;25;506;538;1
pilski;301900;7;37;4;33;535;873;1
pleszewski;302000;1;125;9;116;269;381;4
pleszewski;302000;2;35;4;31;402;460;1
pleszewski;302000;3;20;3;17;384;399;1
pleszewski;302000;4;35;3;32;204;260;2
poznański;302100;1;28;4;24;1146;945;0
poznański;302100;2;31;4;27;869;817;0
poznański;302100;3;31;4;27;637;1262;3
poznański;302100;4;32;4;28;513;1412;3
poznański;302100;5;37;5;32;771;1160;2
poznański;302100;6;29;4;25;1299;1483;1
poznański;302100;7;30;4;26;863;901;1
rawicki;302200;1;31;3;28;150;253;4
rawicki;302200;2;31;4;27;275;239;0
rawicki;302200;3;28;3;25;296;229;0
rawicki;302200;4;78;9;69;226;218;0
słupecki;302300;1;38;4;34;258;361;2
słupecki;302300;2;34;4;30;300;415;3
słupecki;302300;3;28;3;25;285;402;2
słupecki;302300;4;27;3;24;364;326;0
słupecki;302300;5;27;3;24;295;260;0
szamotulski;302400;1;32;3;29;474;309;0
szamotulski;302400;2;33;4;29;367;271;0
szamotulski;302400;3;36;3;33;190;341;3
szamotulski;302400;4;78;7;71;368;339;0
szamotulski;302400;5;41;4;37;206;482;3
średzki;302500;1;108;9;99;150;367;13
średzki;302500;2;42;3;39;269;266;0
średzki;302500;3;63;5;58;134;255;4
śremski;302600;1;51;5;46;260;318;1
śremski;302600;2;54;6;48;296;369;2
śremski;302600;3;57;6;51;179;311;5
turecki;302700;1;82;7;75;318;441;1
turecki;302700;2;82;7;75;358;368;1
turecki;302700;3;47;4;43;458;511;1
turecki;302700;4;36;3;33;318;517;1
wągrowiecki;302800;1;59;7;52;260;292;2
wągrowiecki;302800;2;37;5;32;346;313;0
wągrowiecki;302800;3;32;4;28;254;225;0
wągrowiecki;302800;4;27;3;24;174;256;3
wolsztyński;302900;1;31;4;27;284;444;1
wolsztyński;302900;2;36;4;32;187;316;2
wolsztyński;302900;3;76;9;67;321;370;1
wrzesiński;303000;1;43;4;39;186;411;5
wrzesiński;303000;2;41;4;37;308;561;1
wrzesiński;303000;3;47;4;43;229;246;1
wrzesiński;303000;4;83;7;76;347;334;0
złotowski;303100;1;40;5;35;158;247;7
złotowski;303100;2;29;3;26;287;400;1
złotowski;303100;3;24;3;21;451;381;0
złotowski;303100;4;47;5;42;297;243;0
złotowski;303100;5;21;3;18;314;366;1
Kalisz;306101;1;60;5;55;287;253;0
Kalisz;306101;2;60;5;55;297;278;0
Kalisz;306101;3;65;5;60;464;509;1
Kalisz;306101;4;60;5;55;416;323;0
Kalisz;306101;5;59;5;54;228;321;1
Konin;306201;1;46;5;41;308;369;2
Konin;306201;2;64;7;57;292;277;0
Konin;306201;3;36;5;31;384;351;0
Konin;306201;4;55;6;49;146;365;4
Leszno;306301;1;59;6;53;287;276;0
Leszno;306301;2;49;5;44;305;280;0
Leszno;306301;3;59;6;53;138;149;2
Leszno;306301;4;60;6;54;196;265;3
Poznań;306401;1;76;6;70;777;1383;1
Poznań;306401;2;56;5;51;890;844;0
Poznań;306401;3;60;5;55;1759;1124;0
Poznań;306401;4;69;6;63;1108;1054;0
Poznań;306401;5;60;5;55;1113;907;0
Poznań;306401;6;58;5;53;1177;1414;2
Poznań;306401;7;65;5;60;1251;1369;2
białogardzki;320100;1;100;9;91;367;234;0
białogardzki;320100;2;56;5;51;253;263;1
białogardzki;320100;3;29;3;26;205;262;2
choszczeński;320200;1;22;3;19;317;371;2
choszczeński;320200;2;53;7;46;323;328;1
choszczeński;320200;3;24;4;20;266;425;2
choszczeński;320200;4;19;3;16;225;204;0
drawski;320300;1;42;5;37;448;406;0
drawski;320300;2;75;7;68;209;287;1
drawski;320300;3;51;5;46;271;358;1
goleniowski;320400;1;42;8;34;304;372;3
goleniowski;320400;2;42;6;36;436;380;0
goleniowski;320400;3;32;5;27;405;376;0
gryficki;320500;1;130;9;121;140;301;7
gryficki;320500;2;85;6;79;314;538;2
gryficki;320500;3;50;4;46;184;258;2
gryfiński;320600;1;99;8;91;284;402;6
gryfiński;320600;2;46;4;42;282;286;1
gryfiński;320600;3;49;6;43;351;384;2
gryfiński;320600;4;24;3;21;266;273;1
kamieński;320700;1;92;5;87;277;249;0
kamieński;320700;2;65;4;61;161;258;5
kamieński;320700;3;68;4;64;114;198;7
kamieński;320700;4;63;4;59;140;194;2
kołobrzeski;320800;1;22;3;19;436;339;0
kołobrzeski;320800;2;29;3;26;271;319;1
kołobrzeski;320800;3;24;3;21;216;274;2
kołobrzeski;320800;4;28;3;25;336;541;1
kołobrzeski;320800;5;20;3;17;469;308;0
kołobrzeski;320800;6;36;4;32;309;276;0
koszaliński;320900;1;32;4;28;349;325;0
koszaliński;320900;2;37;5;32;262;257;0
koszaliński;320900;3;27;3;24;286;385;1
koszaliński;320900;4;27;3;24;362;276;0
koszaliński;320900;5;42;4;38;304;270;0
myśliborski;321000;1;36;6;30;331;321;0
myśliborski;321000;2;40;7;33;311;465;4
myśliborski;321000;3;40;6;34;295;388;3
policki;321100;1;25;3;22;248;358;1
policki;321100;2;44;5;39;244;328;4
policki;321100;3;28;3;25;238;380;2
policki;321100;4;38;4;34;291;279;0
policki;321100;5;39;4;35;179;324;4
pyrzycki;321200;1;64;8;56;205;261;2
pyrzycki;321200;2;28;3;25;172;174;1
pyrzycki;321200;3;46;6;40;182;294;6
sławieński;321300;1;44;4;40;223;315;3
sławieński;321300;2;38;4;34;235;302;1
sławieński;321300;3;46;4;42;301;451;1
sławieński;321300;4;53;5;48;200;329;2
stargardzki;321400;1;38;4;34;464;436;0
stargardzki;321400;2;37;4;33;398;528;1
stargardzki;321400;3;44;5;39;447;412;0
stargardzki;321400;4;28;4;24;393;496;1
stargardzki;321400;5;23;3;20;461;500;1
stargardzki;321400;6;26;3;23;614;492;0
szczecinecki;321500;1;103;10;93;155;315;15
szczecinecki;321500;2;50;6;44;285;488;3
szczecinecki;321500;3;27;3;24;252;429;4
świdwiński;321600;1;52;5;47;191;305;1
świdwiński;321600;2;32;3;29;253;284;1
świdwiński;321600;3;53;6;47;153;307;4
świdwiński;321600;4;27;3;24;393;325;0
wałecki;321700;1;87;8;79;224;220;0
wałecki;321700;2;44;4;40;259;222;0
wałecki;321700;3;52;5;47;287;393;1
łobeski;321800;1;41;6;35;174;226;2
łobeski;321800;2;18;3;15;217;241;1
łobeski;321800;3;18;3;15;276;253;0
łobeski;321800;4;18;3;15;307;211;0
Koszalin;326101;1;59;5;54;318;643;1
Koszalin;326101;2;60;5;55;369;280;0
Koszalin;326101;3;60;5;55;357;454;1
Koszalin;326101;4;59;5;54;200;572;2
Koszalin;326101;5;60;5;55;340;327;0
Szczecin;326201;1;104;7;97;1006;1101;1
Szczecin;326201;2;99;7;92;799;1249;2
Szczecin;326201;3;85;5;80;866;1300;2
Szczecin;326201;4;94;6;88;1405;1148;0
Szczecin;326201;5;91;6;85;1278;1360;1
Świnoujście;326301;1;103;8;95;78;153;6
Świnoujście;326301;2;78;6;72;168;216;2
Świnoujście;326301;3;85;7;78;112;227;6
